NORMALIZACION DE WIDGETS	NOMENCLATURA	
		
ALTA DE GUARDIA	adg	
INGRESO DE DOTACION MEDICOS	idm	
INGRESO DE DOTACION ENFERMEROS	ide	
GUARDIAS CABINA	gcab	
		
		
		
TIPO DE WIDGETS:		
		
CHECKBOX	ckb      	
BUTTON	btn	se pone en todo lo que aparezca como boton
CALENDAR	cal	
COMBO	comb	
COMMANDLINKBUTTON	clb	
DATEEDIT	date	solo fecha
DATETIME	fyh	fecha y hora
FRAME	frm	
GRIDLAYOUT	glay	
HORIZONTALLAYOUT	hlay	
LABEL	lbl	
LINEEDIT	let	
STACKEDWIDGET	stwid	
TABLE	tbl	
TABLEVIEW	tblv	
TEXTEDIT	txe	
TIMEEDIT	time	
TOOLBOX	tlbox	
